NO ./textures/bricks.xpm
SO ./textures/glass.xpm
WE ./textures/rocks.xpm
EA ./textures/bookshelf.xpm

F 220,100,0
C 225,30,0

111111
1  N  1
100001

111111